adt	[axl ' aes k ax d ' eyl ayt  t ' aym ]
adt.	[axl ' aes k ax d ' eyl ayt  t ' aym ]
ak	[axl ' aes k ax]
ak.	[axl ' aes k ax]
apr	[' eyp r axl ]
apr.	[' eyp r axl ]
ar	[' aar k axn s ao]
ar.	[' aar k axn s ao]
ast	[axl ' aes k ax st ' aen d rrd  t ' aym ]
ast.	[axl ' aes k ax st ' aen d rrd  t ' aym ]
attn	[axt ' ehn shaxn ]
attn.	[axt ' ehn shaxn ]
atty	[axt ' rrn iy]
atty.	[axt ' rrn iy]
aug	[' aog axs t ]
aug.	[' aog axs t ]
av	[' aev axn uw]
av.	[' aev axn uw]
avbl	[axv ' eyl axb axl ]
avbl.	[axv ' eyl axb axl ]
ave	[' aev axn uw]
ave.	[' aev axn uw]
az	[aer axz ' own ax]
az.	[aer axz ' own ax]
bldg	[b ' ihl d ixnx]
bldg.	[b ' ihl d ixnx]
blvd	[b ' uhl axv ' aar d ]
blvd.	[b ' uhl axv ' aar d ]
ca	[k ' ael axf ' owr n iyax]
ca.	[k ' ael axf ' owr n iyax]
calif	[k ' ael axf ' owr n iyax]
calif.	[k ' ael axf ' owr n iyax]
cdt	[s ' ehn t r axl  d ' eyl ayt  t ' aym ]
cdt.	[s ' ehn t r axl  d ' eyl ayt  t ' aym ]
cir	[s ' rrk axl ]
cir.	[s ' rrk axl ]
cldy	[k l ' awd iy]
cldy.	[k l ' awd iy]
corp	[k ' aor p rr' eyshaxn ]
corp.	[k ' aor p rr' eyshaxn ]
cst	[s ' ehn t r axl  st ' aen d rrd  t ' aym ]
cst.	[s ' ehn t r axl  st ' aen d rrd  t ' aym ]
dec	[d ixs ' ehm b rr]
dec.	[d ixs ' ehm b rr]
dep	[d ihp ' aar t m axn t ]
dep.	[d ihp ' aar t m axn t ]
dept	[d ihp ' aar t m axn t ]
dept.	[d ihp ' aar t m axn t ]
doz	[d ' ahz axn ]
doz.	[d ' ahz axn ]
drs	[d ' aok t rrz ]
drs.	[d ' aok t rrz ]
e.g.	[f owr ihg z ' aem p axl ]
edt	[' iys t rrn  d ' eyl ayt  t ' aym ]
edt.	[' iys t rrn  d ' eyl ayt  t ' aym ]
ene	[' iys t  n aor th* ' iys t ]
ene.	[' iys t  n aor th* ' iys t ]
ese	[' iys t  s awth* ' iys t]
ese.	[' iys t  s awth* ' iys t]
esp	[ixs p ' ehshaxl iy]
esp.	[ixs p ' ehshaxl iy]
est	[' iys t rrn  st ' aen d rrd  t ' aym ]
est.	[' iys t rrn  st ' aen d rrd  t ' aym ]
etc	[eht s ' eht rrax]
etc.	[eht s ' eht rrax]
expwy	[ihk s p r ' ehs w ` ey]
expwy.	[ihk s p r ' ehs w ` ey]
feb	[f ' ehb r uw` ehr iy]
feb.	[f ' ehb r uw` ehr iy]
fl	[f l ' owr ihd ax]
fl.	[f l ' owr ihd ax]
fla	[f l ' owr ihd ax]
fla.	[f l ' owr ihd ax]
fri	[f r ' ayd ey]
fri.	[f r ' ayd ey]
ga	[jh' owr jhax]
ga.	[jh' owr jhax]
gu	[g w ' aam ]
gu.	[g w ' aam ]
ht	[hx' ayt ]
ht.	[hx' ayt ]
hwy	[hx' ay* w ` ey]
hwy.	[hx' ay* w ` ey]
hx	[hx' iyt * ` ihn d ehk s ]
hx.	[hx' iyt * ` ihn d ehk s ]
i.e.	[dhaet ihz ]
ia	[' ayowax]
ia.	[' ayowax]
il	[` ihl axn ' oy]
il.	[` ihl axn ' oy]
inc	[ihn k ' aor p rr` eyt ixd ]
inc.	[ihn k ' aor p rr` eyt ixd ]
jr	[jh' uwn yxrr]
jr.	[jh' uwn yxrr]
jul	[jhuwl ' ay]
jul.	[jhuwl ' ay]
jun	[jh' uwn]
jun.	[jh' uwn]
ks	[k ' aen z axs ]
ks.	[k ' aen z axs ]
kts	[n ' aat s ]
kts.	[n ' aat s ]
ky	[k axn t ' ahk iy]
ky.	[k axn t ' ahk iy]
lbs	[p ' awn d z ]
lbs.	[p ' awn d z ]
ln	[l ' eyn ]
ln.	[l ' eyn ]
lon	[l ' aan jhiht uwd ]
lon.	[l ' aan jhiht uwd ]
ltd	[l ' ihm iht ixd ]
ltd.	[l ' ihm iht ixd ]
lx	[s ' ihk s t iy]
lx.	[s ' ihk s t iy]
lxx	[s ' ehv axn t iy]
lxx.	[s ' ehv axn t iy]
lxxx	[' eyt iy]
lxxx.	[' eyt iy]
mdt	[m ' awn t axn  d ' eyl ayt  t ' aym ]
mdt.	[m ' awn t axn  d ' eyl ayt  t ' aym ]
mme	[m ' aed axm ]
mme.	[m ' aed axm ]
mmes	[m eyd ' aam ]
mmes.	[m eyd ' aam ]
mn	[m ` ihn axs ' owt ax]
mn.	[m ` ihn axs ' owt ax]
mon	[m ' ahn d ey]
mon.	[m ' ahn d ey]
mr	[m ' ihs t rr]
mr.	[m ' ihs t rr]
mrs	[m ' ihs ihz ]
mrs.	[m ' ihs ihz ]
msgr	[m aan s ' iyn yxrr]
msgr.	[m aan s ' iyn yxrr]
mssrs	[m eys yx' uhr z ]
mssrs.	[m eys yx' uhr z ]
mst	[m ' awn t axn  st ' aen d rrd  t ' aym ]
mst.	[m ' awn t axn  st ' aen d rrd  t ' aym ]
n.c.	[n ' aor th k aer axl ' ayn ax]
n.d.	[n ' aor th d axk ' owt ax]
n.h.	[n ' uw hx' aem p shrr]
n.j.	[n ' uw jh' rrz iy]
n.m.	[n ' uw m ' ehk s ihk ow]
n.y.	[n ' uw yx' aor k ]
nb	[n ' owt ax b ' ehn eh]
nb.	[n ' owt ax b ' ehn eh]
nc	[n ' aor th k aer axl ' ayn ax]
nd	[n ' aor th d axk ' owt ax]
nh	[n ' uw hx' aem p shrr]
nj	[n ' uw jh' rrz iy]
nm	[n ' uw m ' ehk s ihk ow]
nne	[n ' aor th n owr th* ' iys t ]
nne.	[n ' aor th n owr th* ' iys t ]
nnw	[n ' aor th n owr th* w ' ehs t ]
nnw.	[n ' aor th n owr th* w ' ehs t ]
nos	[n ' ahm b rrz ]
nos.	[n ' ahm b rrz ]
nov	[n owv ' ehm b rr]
nov.	[n owv ' ehm b rr]
nv	[n axv ' aed ax]
nv.	[n axv ' aed ax]
nw	[n aor th* w ' ehs t ]
nw.	[n aor th* w ' ehs t ]
nws	[n ' aeshaxn axl  w ' ehdhrr s ' rrv ihs ]
nws.	[n ' aeshaxn axl  w ' ehdhrr s ' rrv ihs ]
ny	[n ' uw yx' aor k ]
obs	[aab s rrv ' eyshaxn ]
obs.	[aab s rrv ' eyshaxn ]
oct	[aak t ' owb rr]
oct.	[aak t ' owb rr]
pdt	[p axs ' ihf ihk  d ' eyl ayt  t ' aym ]
pdt.	[p axs ' ihf ihk  d ' eyl ayt  t ' aym ]
pkwy	[p ' aar k w ` ey]
pkwy.	[p ' aar k w ` ey]
pl	[p l ' eys ]
pl.	[p l ' eys ]
pp	[p ' eyjhixz ]
pp.	[p ' eyjhixz ]
pst	[p axs ' ihf ihk  st ' aen d rrd  t ' aym ]
pst.	[p axs ' ihf ihk  st ' aen d rrd  t ' aym ]
qty	[k w ' aon t iht iy]
qty.	[k w ' aon t iht iy]
r.i.	[r ' owd  ' ayl ixn d ]
rd	[r ' owd ]
rd.	[r ' owd ]
ri	[r ' owd  ' ayl ixn d ]
rm	[r ' uwm ]
rm.	[r ' uwm ]
rte	[r ' uwt ]
rte.	[r ' uwt ]
s.c.	[s ' awth k aer axl ' ayn ax]
s.d.	[s ' awth d axk ' owt ax]
sae	[s ' ehl f  axd r ' ehs t  ' ehn v axl owp ]
sae.	[s ' ehl f  axd r ' ehs t  ' ehn v axl owp ]
sc	[s ' awth k aer axl ' ayn ax]
sd	[s ' awth d axk ' owt ax]
sen	[s ' ehn axt rr]
sen.	[s ' ehn axt rr]
sep	[s ehp t ' ehm b rr]
sep.	[s ehp t ' ehm b rr]
sept	[s ehp t ' ehm b rr]
sept.	[s ehp t ' ehm b rr]
sgt	[s ' aar jhaxn t ]
sgt.	[s ' aar jhaxn t ]
sq	[s k w ' eyr ]
sq.	[s k w ' eyr ]
sr	[s ' iyn yxrr]
sr.	[s ' iyn yxrr]
sse	[s ' awth s awth* ' iys t ]
sse.	[s ' awth s awth* ' iys t ]
ssw	[s ' awth s awth* w ' ehs t ]
ssw.	[s ' awth s awth* w ' ehs t ]
ste	[s w ' iyt ]
ste.	[s w ' iyt ]
sts	[s t r ' iyt s ]
sts.	[s t r ' iyt s ]
subj	[s ' ahb jhihk t ]
subj.	[s ' ahb jhihk t ]
sw	[s awth* w ' ehs t ]
sw.	[s awth* w ' ehs t ]
tel	[t ' ehl axf ` own ]
tel.	[t ' ehl axf ` own ]
temp	[t ' ehm p r axchrr ]
temp.	[t ' ehm p r axchrr ]
terr	[t ' ehr axs ]
terr.	[t ' ehr axs ]
thu	[th' rrz d ey]
thu.	[th' rrz d ey]
thur	[th' rrz d ey]
thur.	[th' rrz d ey]
thurs	[th' rrz d ey]
thurs.	[th' rrz d ey]
ti	[t ' ehk s axs  ' ihn s t r axm axn t s ]
ti.	[t ' ehk s axs  ' ihn s t r axm axn t s ]
tn	[t ehn axs ' iy]
tn.	[t ehn axs ' iy]
tu	[t ' uwz d ey]
tu.	[t ' uwz d ey]
tue	[t ' uwz d ey]
tue.	[t ' uwz d ey]
tues	[t ' uwz d ey]
tues.	[t ' uwz d ey]
tx	[t ' ehk s axs ]
tx.	[t ' ehk s axs ]
ut	[' yut ao]
ut.	[' yut ao]
vi	[v ' rrjhihn  ' ayl axn d z ]
vi.	[v ' rrjhihn  ' ayl axn d z ]
vol	[v ' aal yum ]
vol.	[v ' aal yum ]
vs	[v ' rrs axs ]
vs.	[v ' rrs axs ]
vt	[v rrm ' aan t ]
vt.	[v rrm ' aan t ]
w.v.	[w ' ehs t  v rrjh' ihn yxax]
wci	[w ' ihn d  ch' ihl  ' ihn d ehk s ]
wci.	[w ' ihn d  ch' ihl  ' ihn d ehk s ]
wi	[w ihs k ' aan s axn ]
wi.	[w ihs k ' aan s axn ]
wnw	[w ' ehs t  n aor th* w ' ehs t ]
wnw.	[w ' ehs t  n aor th* w ' ehs t ]
wsw	[w ' ehs t  s awth* w ' ehs t ]
wsw.	[w ' ehs t  s awth* w ' ehs t ]
wv	[w ' ehs t  v rrjh' ihn yxax]
xmas	[k r ' ihs m axs ]
xmas.	[k r ' ihs m axs ]
yrs	[yx' iyr z ]
yrs.	[yx' iyr z ]
